1111111111111111111111111
1000000000000000000000111
1100000000000000000001111
1100000000000000000000011
1100000000000000000011111
1100000000000000000000111
1111111111111111111111111
1111111111111111111111111
1100000000000000000000111
1100000000000000000000011
1110000000000000000000011
1110000000000000000001111
1111111111111111111111111
