NO	./parssing/src/Wall-Grass_01_L-128x128.xpm
SO	./parssing/src/Wall-Roofs_01_L-128x128.xpm
EA	./parssing/src/Wall-Stone_01_L-128x128.xpm
WE	./parssing/src/Wall-Wood_01_L-128x128.xpm

F 0,200,0
C 0,0,200

        1111111111111111111111111
        1N00000000110000000000001
        1011000001110000000000001
        1001000000000000000000001
111111111011000001110000000000001
100000000011000001110111111111111
11110111111110011100000010001
11110111111110011101010010001
11000000110100011100000010001
10000000000000001100000010001
10000000000000001101010010001
110000011101000111110111100111
11110111 1100101 101111010001
11111111 1100111 111111011111
        1110011111111110111111111
        1000000000110000000000001
        1011000001110000000000001
        1001000000000000000000001
111111111011000001110000000000001
100000000011000001110111111111111
11110111111110011100000010001
11110111111110011101010010001
11000000110100011100000010001
10000000000000001100000010001
10000000000000001101010010001
110000011101010111110111100111
11110111 1110101 101111010001
11111111 1111111 111111111111
11110111 1100101 101111010001
11111111 1100111 111111011111
        1110011111111110111111111
        1000000000110000000000001
        1011000001110000000000001
        1001000000000000000000001
111111111011000001110000000000001
100000000011000001110111111111111
11110111111110011100000010001
11110111111110011101010010001
11000000110100011100000010001
10000000000000001100000010001
10000000000000001101010010001
110000011101010111110111100111
11110111 1110101 101111010001
11111111 1111111 111111111111